###############################
#.............................#
#.#.#.#.#.#.#.#.#.#.#.#.#.#.#.#
#.............................#
#.#.#.#.#.#.#.#.#.#.#.#.#.#.#.#
#.............................#
#.#.#.#.#.#.#.#.#.#.#.#.#.#.#.#
#.............................#
#.#.#.#.#.#.#.#.#.#.#.#.#.#.#.#
#.............................#
#.#.#.#.#.#.#.#.#.#.#.#.#.#.#.#
#.............................#
###############################