@............................
.#.#.#.#.#.#.#.#.#.#.#.#.#.#.
.............................
.#.#.#.#.#.#.#.#.#.#.#.#.#.#.
.............................
.#.#.#.#.#.#.#.#.#.#.#.#.#.#.
.............................
.#.#.#.#.#.#.#.#.#.#.#.#.#.#.
.............................
.#.#.#.#.#.#.#.#.#.#.#.#.#.#.
.............................